111111111111111111111111111111
1E1000000000000C00000C000001C1
111001010010000010100100010101
101001001010101000100100010101
10CCC0000C00C0000000000000CCC1
101001010010000010100100010101
101001001010101000100100010101
10CCC0000C00C0000000000000CCC1
101001010010000011001000101001
101001001010101000100100010101
10CCC0000C00C0000000000000CCC1
101001010010000010100100010101
101001001010101000100100001011
10CCC0000C00C000000000P0000CC1
111111111111111111111111111111